//MAP CONVERTED BY dmm2tgm.py THIS HEADER COMMENT PREVENTS RECONVERSION, DO NOT REMOVE
"a" = (
/obj/machinery/door/airlock/titanium{
	name = "Arrivals Shuttle Airlock"
	},
/turf/open/floor/mineral/titanium/blue,
/area/shuttle/arrival)
"b" = (
/turf/open/floor/plating/airless,
/area/shuttle/arrival)
"c" = (
/obj/effect/spawner/structure/window/reinforced/shuttle,
/turf/open/floor/plating/airless,
/area/shuttle/arrival)
"d" = (
/obj/machinery/light/directional/north,
/turf/open/floor/mineral/titanium/blue,
/area/shuttle/arrival)
"e" = (
/obj/machinery/vending/wallmed/directional/north,
/turf/open/floor/mineral/titanium/blue,
/area/shuttle/arrival)
"f" = (
/obj/machinery/power/shuttle_engine/large{
	dir = 8
	},
/turf/open/floor/plating/airless,
/area/shuttle/arrival)
"g" = (
/obj/effect/spawner/structure/window/reinforced/shuttle,
/turf/open/floor/plating,
/area/shuttle/arrival)
"h" = (
/obj/machinery/requests_console{
	department = "Arrival shuttle";
	name = "Arrivals Shuttle console"
	},
/turf/closed/wall/mineral/titanium,
/area/shuttle/arrival)
"i" = (
/obj/structure/chair/comfy/shuttle{
	dir = 4
	},
/turf/open/floor/mineral/titanium,
/area/shuttle/arrival)
"l" = (
/obj/structure/chair/comfy/shuttle{
	dir = 4
	},
/turf/open/floor/mineral/titanium/blue,
/area/shuttle/arrival)
"m" = (
/obj/machinery/light/small/directional/west,
/turf/open/floor/mineral/titanium/blue,
/area/shuttle/arrival)
"n" = (
/obj/effect/turf_decal/delivery,
/obj/structure/rack,
/turf/open/floor/mineral/plastitanium,
/area/shuttle/arrival)
"q" = (
/obj/docking_port/mobile/arrivals{
	dir = 4
	},
/turf/closed/wall/mineral/titanium,
/area/shuttle/arrival)
"r" = (
/obj/machinery/modular_computer/console/preset/cargochat{
	dir = 8
	},
/turf/open/floor/mineral/titanium/blue,
/area/shuttle/arrival)
"s" = (
/turf/open/space/basic,
/area/template_noop)
"t" = (
/obj/structure/closet/wardrobe/green,
/obj/machinery/light/directional/south,
/turf/open/floor/mineral/titanium/blue,
/area/shuttle/arrival)
"w" = (
/obj/structure/table,
/turf/open/floor/mineral/titanium/blue,
/area/shuttle/arrival)
"x" = (
/obj/structure/table,
/obj/item/radio/intercom/directional/east,
/obj/item/flashlight,
/obj/item/radio{
	pixel_y = 4
	},
/obj/item/radio{
	pixel_x = 6;
	pixel_y = 6
	},
/obj/item/radio{
	pixel_x = -6;
	pixel_y = 6
	},
/turf/open/floor/mineral/titanium,
/area/shuttle/arrival)
"y" = (
/turf/open/floor/mineral/titanium,
/area/shuttle/arrival)
"z" = (
/obj/structure/sign/warning/fire,
/turf/closed/wall/mineral/titanium,
/area/shuttle/arrival)
"A" = (
/obj/structure/chair/comfy/shuttle{
	dir = 4
	},
/obj/machinery/light/directional/south,
/turf/open/floor/mineral/titanium,
/area/shuttle/arrival)
"B" = (
/turf/open/floor/mineral/titanium/blue,
/area/shuttle/arrival)
"C" = (
/obj/machinery/light/directional/south,
/turf/open/floor/mineral/titanium/blue,
/area/shuttle/arrival)
"F" = (
/obj/effect/turf_decal/delivery,
/obj/item/storage/toolbox/emergency,
/obj/item/storage/toolbox/emergency,
/obj/structure/rack,
/turf/open/floor/mineral/plastitanium,
/area/shuttle/arrival)
"G" = (
/obj/machinery/door/airlock/titanium{
	name = "Arrivals Shuttle Airlock"
	},
/obj/structure/fans/tiny,
/turf/open/floor/plating,
/area/shuttle/arrival)
"J" = (
/obj/structure/chair/comfy/shuttle{
	dir = 8
	},
/obj/machinery/light/directional/north,
/turf/open/floor/mineral/titanium,
/area/shuttle/arrival)
"K" = (
/obj/structure/closet/wardrobe/black,
/turf/open/floor/mineral/titanium/blue,
/area/shuttle/arrival)
"L" = (
/obj/machinery/computer/atmos_alert{
	dir = 8
	},
/turf/open/floor/mineral/titanium/blue,
/area/shuttle/arrival)
"M" = (
/obj/structure/closet/emcloset,
/obj/machinery/light/directional/south,
/turf/open/floor/mineral/titanium/blue,
/area/shuttle/arrival)
"N" = (
/obj/structure/closet/emcloset,
/turf/open/floor/mineral/titanium/blue,
/area/shuttle/arrival)
"O" = (
/obj/structure/sign/nanotrasen,
/turf/closed/wall/mineral/titanium,
/area/shuttle/arrival)
"P" = (
/turf/closed/wall/mineral/titanium,
/area/shuttle/arrival)
"R" = (
/obj/structure/chair/comfy/shuttle{
	dir = 4
	},
/obj/machinery/light/directional/north,
/turf/open/floor/mineral/titanium,
/area/shuttle/arrival)
"S" = (
/obj/structure/table,
/obj/item/storage/medkit/regular,
/obj/machinery/light/directional/north,
/turf/open/floor/mineral/titanium,
/area/shuttle/arrival)
"T" = (
/obj/structure/chair/comfy/shuttle{
	dir = 8
	},
/obj/machinery/light/directional/south,
/turf/open/floor/mineral/titanium,
/area/shuttle/arrival)
"V" = (
/obj/structure/chair/comfy/shuttle{
	dir = 8
	},
/turf/open/floor/mineral/titanium,
/area/shuttle/arrival)
"W" = (
/obj/structure/chair/comfy/shuttle{
	dir = 4
	},
/obj/machinery/requests_console/directional/north{
	department = "Arrival shuttle"
	},
/obj/machinery/light/directional/north,
/turf/open/floor/mineral/titanium,
/area/shuttle/arrival)
"X" = (
/obj/item/clothing/suit/hazardvest{
	desc = "A high-visibility lifejacket complete with whistle and slot for oxygen tanks.";
	name = "emergency lifejacket"
	},
/obj/item/clothing/suit/hazardvest{
	desc = "A high-visibility lifejacket complete with whistle and slot for oxygen tanks.";
	name = "emergency lifejacket"
	},
/obj/item/tank/internals/emergency_oxygen{
	pixel_x = 3
	},
/obj/item/tank/internals/emergency_oxygen{
	pixel_x = 3
	},
/obj/item/clothing/mask/breath{
	pixel_x = -3;
	pixel_y = -3
	},
/obj/item/clothing/mask/breath{
	pixel_x = -3;
	pixel_y = -3
	},
/obj/item/clothing/head/utility/hardhat/orange{
	name = "protective hat";
	pixel_y = 9
	},
/obj/item/clothing/head/utility/hardhat/orange{
	name = "protective hat";
	pixel_y = 9
	},
/obj/structure/closet/crate/internals,
/obj/effect/turf_decal/delivery,
/turf/open/floor/mineral/plastitanium,
/area/shuttle/arrival)

(1,1,1) = {"
s
s
s
s
s
P
q
P
s
s
s
s
s
"}
(2,1,1) = {"
P
b
f
P
g
P
P
P
g
P
b
f
P
"}
(3,1,1) = {"
z
b
b
P
X
X
B
F
n
P
b
b
z
"}
(4,1,1) = {"
s
P
P
P
R
i
B
i
A
P
P
P
s
"}
(5,1,1) = {"
s
P
P
P
i
i
B
i
i
P
P
P
s
"}
(6,1,1) = {"
s
s
P
P
R
i
B
i
A
P
P
s
s
"}
(7,1,1) = {"
s
s
P
P
i
i
B
i
i
P
P
s
s
"}
(8,1,1) = {"
s
s
s
P
P
h
B
O
P
P
s
s
s
"}
(9,1,1) = {"
s
s
s
P
R
i
B
i
A
P
s
s
s
"}
(10,1,1) = {"
s
s
s
g
y
y
B
y
y
g
s
s
s
"}
(11,1,1) = {"
s
s
s
P
J
V
B
V
T
P
s
s
s
"}
(12,1,1) = {"
s
s
s
P
P
P
e
O
P
P
s
s
s
"}
(13,1,1) = {"
s
s
s
P
W
i
B
B
t
P
s
s
s
"}
(14,1,1) = {"
s
s
s
G
B
B
B
B
K
P
s
s
s
"}
(15,1,1) = {"
s
s
s
G
B
B
B
B
N
P
s
s
s
"}
(16,1,1) = {"
s
s
s
O
S
x
B
B
M
O
s
s
s
"}
(17,1,1) = {"
s
s
s
P
P
P
a
P
P
P
s
s
s
"}
(18,1,1) = {"
s
s
s
P
B
m
B
m
B
P
s
s
s
"}
(19,1,1) = {"
s
s
s
P
d
l
w
l
C
P
s
s
s
"}
(20,1,1) = {"
s
s
s
P
P
r
w
L
P
P
s
s
s
"}
(21,1,1) = {"
s
s
s
s
P
c
c
c
P
s
s
s
s
"}
